"a" = (/turf/space,/area/space)
"b" = (/turf/simulated/floor,/area/space)

(1,1,1) = {"
aaaaaaaaaaaaaaaaaaaaaaaaaaaaaaaaaaaaaaaa
aaaaaaaaaaaaaaaaaaaaaaaaaaaaaaaaaaaaaaaa
aaaaaaaaaaaaaaaaaaaaaaaaaaaaaaaaaaaaaaaa
aaaaaaaaaaaaaaaaaaaaaaaaaaaaaaaaaaaaaaaa
aaaaaaaaaaaaaaaabbbbbbbbaaaaaaaaaaaaaaaa
aaaaaaaaaaaaaaabbbbbbbbbbaaaaaaaaaaaaaaa
aaaaaaaaaaaaaabbbbbbbbbbbbaaaaaaaaaaaaaa
aaaaaaaaaaaaabbbbbbbbbbbbbbaaaaaaaaaaaaa
aaaaaaaaaaaabbbbbbbbbbbbbbbbaaaaaaaaaaaa
aaaaaaaaaaabbbbbbbbbbbbbbbbbbaaaaaaaaaaa
aaaaaaaaaabbbbbbbbbbbbbbbbbbbbaaaaaaaaaa
aaaaaaaaaabbbbbbbbbbbbbbbbbbbbaaaaaaaaaa
aaaaaaaaaabbbbbbbbbbbbbbbbbbbbaaaaaaaaaa
aaaaaaaaaabbbbbbbbbbbbbbbbbbbbaaaaaaaaaa
aaaaaaaaaabbbbbbbbbbbbbbbbbbbbaaaaaaaaaa
aaaaaaaaaabbbbbbbbbbbbbbbbbbbbaaaaaaaaaa
aaaaaaaaaabbbbbbbbbbbbbbbbbbbbaaaaaaaaaa
aaaaaaaaaabbbbbbbbbbbbbbbbbbbbaaaaaaaaaa
aaaaaaaaaabbbbbbbbbbbbbbbbbbbbaaaaaaaaaa
aaaaaaaaaabbbbbbbbbbbbbbbbbbbbaaaaaaaaaa
aaaaaaaaaabbbbbbbbbbbbbbbbbbbbaaaaaaaaaa
aaaaaaaaaabbbbbbbbbbbbbbbbbbbbaaaaaaaaaa
aaaaaaaaaabbbbbbbbbbbbbbbbbbbbaaaaaaaaaa
aaaaaaaaaabbbbbbbbbbbbbbbbbbbbaaaaaaaaaa
aaaaaaaaaabbbbbbbbbbbbbbbbbbbbaaaaaaaaaa
aaaaaaaaaabbbbbbbbbbbbbbbbbbbbaaaaaaaaaa
aaaaaaaaaabbbbbbbbbbbbbbbbbbbbaaaaaaaaaa
aaaaaaaaaabbbbbbbbbbbbbbbbbbbbaaaaaaaaaa
aaaaabbbbbbbbbbbbbbbbbbbbbbbbbbbbbbaaaaa
aaaaabbbbbbbbbbbbbbbbbbbbbbbbbbbbbbaaaaa
aaaaabbbbbbbbbbbbbbbbbbbbbbbbbbbbbbaaaaa
aaaaabbbbbbbbbbbbbbbbbbbbbbbbbbbbbbaaaaa
aaaaabbbbbbbbbbbbbbbbbbbbbbbbbbbbbbaaaaa
aaaaabbbbbbbbbbbbbbbbbbbbbbbbbbbbbbaaaaa
aaaaabbbbbbbbbbbbbbbbbbbbbbbbbbbbbbaaaaa
aaaaabbbbbbbbbbbbbbbbbbbbbbbbbbbbbbaaaaa
aaaaabbbbbbbbbaaaaaaaaaaaabbbbbbbbbaaaaa
aaaaaaaaaaaaaaaaaaaaaaaaaaaaaaaaaaaaaaaa
aaaaaaaaaaaaaaaaaaaaaaaaaaaaaaaaaaaaaaaa
aaaaaaaaaaaaaaaaaaaaaaaaaaaaaaaaaaaaaaaa
"}
