"aa" = (/turf/simulated/mineral{name = "Mountain Wall"; nitrogen = 82.1472; oxygen = 21.8366; temperature = 393.15},/area/sheep/snow/graves)
"ab" = (/turf/simulated/floor/plating/snow,/area/sheep/snow/graves)
"ac" = (/turf/simulated/wall,/area/sheep/snow/graves)
"ad" = (/obj/structure/window/reinforced{dir = 1},/turf/simulated/floor/plating/snow,/area/sheep/snow/graves)
"ae" = (/obj/structure/window/reinforced{dir = 1},/obj/item/clothing/accessory/dogtags{name = "Five-Aces' dogtags"},/turf/simulated/floor/plating/snow,/area/sheep/snow/graves)
"af" = (/obj/structure/window/reinforced{dir = 1},/obj/item/clothing/accessory/dogtags{name = "Five-Star's dogtags"},/turf/simulated/floor/plating/snow,/area/sheep/snow/graves)
"ag" = (/obj/structure/window/reinforced{dir = 1},/obj/item/clothing/accessory/holobadge{name = "Natalye 'Cutie' Malone's holobadge"},/turf/simulated/floor/plating/snow,/area/sheep/snow/graves)
"ah" = (/obj/structure/window/reinforced{dir = 1},/obj/item/clothing/accessory/dogtags{name = "Swifsky's dogtags"},/turf/simulated/floor/plating/snow,/area/sheep/snow/graves)
"ai" = (/obj/structure/window/reinforced{dir = 1},/obj/item/clothing/accessory/holobadge{name = "Charlie 'Wrecker' Mane's holobadge"},/turf/simulated/floor/plating/snow,/area/sheep/snow/graves)
"aj" = (/obj/structure/window/reinforced{dir = 1},/obj/item/clothing/accessory/dogtags{name = "Clapper's dogtags"},/turf/simulated/floor/plating/snow,/area/sheep/snow/graves)
"ak" = (/obj/structure/window/reinforced{dir = 1},/obj/item/clothing/accessory/dogtags{name = "Five-O-Five's dogtags"},/turf/simulated/floor/plating/snow,/area/sheep/snow/graves)
"al" = (/obj/structure/window/reinforced{dir = 1},/obj/structure/window/reinforced{dir = 4},/turf/simulated/floor/plating/snow,/area/sheep/snow/graves)
"am" = (/obj/structure/closet/coffin,/turf/simulated/floor/wood,/area/sheep/snow/graves)
"an" = (/turf/simulated/floor{icon_state = "grimy"},/area/sheep/snow/graves)
"ao" = (/obj/structure/table/rack,/obj/item/weapon/reagent_containers/food/drinks/cans/beer,/obj/item/weapon/reagent_containers/food/drinks/cans/beer,/obj/item/weapon/reagent_containers/food/drinks/cans/beer,/turf/simulated/floor{icon_state = "grimy"},/area/sheep/snow/graves)
"ap" = (/obj/structure/table/rack,/obj/item/weapon/reagent_containers/food/drinks/cans/cola,/obj/item/weapon/reagent_containers/food/drinks/cans/cola,/obj/item/weapon/reagent_containers/food/drinks/cans/cola,/turf/simulated/floor{icon_state = "grimy"},/area/sheep/snow/graves)
"aq" = (/obj/structure/table/rack,/obj/item/weapon/claymore,/turf/simulated/floor{icon_state = "grimy"},/area/sheep/snow/graves)
"ar" = (/obj/structure/table/rack,/obj/item/weapon/flame/lighter/zippo,/obj/item/weapon/storage/fancy/candle_box,/obj/item/weapon/storage/box/matches,/turf/simulated/floor{icon_state = "grimy"},/area/sheep/snow/graves)
"as" = (/obj/item/weapon/paper/crumpled{info = "Four down, won't let them get number five!"},/turf/simulated/floor/plating/snow,/area/sheep/snow/graves)
"at" = (/obj/structure/plushie/beepsky,/turf/simulated/floor/plating/snow,/area/sheep/snow/graves)
"au" = (/obj/item/toy/prize/durand,/turf/simulated/floor/plating/snow,/area/sheep/snow/graves)
"av" = (/obj/structure/window/reinforced{dir = 4},/turf/simulated/floor/plating/snow,/area/sheep/snow/graves)
"aw" = (/obj/structure/table/woodentable,/obj/item/weapon/shovel,/turf/simulated/floor/wood,/area/sheep/snow/graves)
"ax" = (/turf/simulated/floor/wood,/area/sheep/snow/graves)
"ay" = (/obj/structure/table/woodentable,/obj/item/weapon/storage/toolbox/mechanical,/turf/simulated/floor/wood,/area/sheep/snow/graves)
"az" = (/obj/structure/table/gamblingtable,/obj/item/weapon/cane/concealed,/turf/simulated/floor{icon_state = "grimy"},/area/sheep/snow/graves)
"aA" = (/obj/structure/table/gamblingtable,/obj/item/weapon/storage/bible,/turf/simulated/floor{icon_state = "grimy"},/area/sheep/snow/graves)
"aB" = (/obj/item/clothing/accessory/holobadge{desc = "The name is illegible."; name = "Unknown's holobadge"},/turf/simulated/floor/plating/snow,/area/sheep/snow/graves)
"aC" = (/obj/item/clothing/accessory/holobadge{name = "Trey 'Giggles' Highwire's holobadge"},/turf/simulated/floor/plating/snow,/area/sheep/snow/graves)
"aD" = (/obj/item/clothing/accessory/holobadge{name = "Christie 'Slaughter' Sinclair's holobadge"},/turf/simulated/floor/plating/snow,/area/sheep/snow/graves)
"aE" = (/obj/item/clothing/head/fedora,/turf/simulated/floor/plating/snow,/area/sheep/snow/graves)
"aF" = (/obj/item/clothing/head/helmet/riot,/turf/simulated/floor/plating/snow,/area/sheep/snow/graves)
"aG" = (/obj/item/clothing/accessory/dogtags{name = "Cinco's dogtags"},/turf/simulated/floor/plating/snow,/area/sheep/snow/graves)
"aH" = (/obj/structure/curtain/open/shower/engineering,/turf/simulated/floor{icon_state = "grimy"},/area/sheep/snow/graves)
"aI" = (/obj/structure/grille,/obj/structure/window/reinforced{dir = 5; health = 1e+007; icon_state = "rwindow4"},/obj/structure/curtain/open/shower/engineering,/turf/simulated/floor{icon_state = "grimy"},/area/sheep/snow/graves)
"aJ" = (/obj/structure/grille,/obj/structure/window/reinforced{dir = 5; health = 1e+007; icon_state = "rwindow8"},/obj/structure/curtain/open/shower/engineering,/turf/simulated/floor{icon_state = "grimy"},/area/sheep/snow/graves)
"aK" = (/obj/structure/table/gamblingtable,/obj/structure/curtain/open/shower/engineering,/obj/item/weapon/reagent_containers/food/drinks/coffee,/turf/simulated/floor{icon_state = "grimy"},/area/sheep/snow/graves)
"aL" = (/obj/structure/table/gamblingtable,/obj/structure/curtain/open/shower/engineering,/turf/simulated/floor{icon_state = "grimy"},/area/sheep/snow/graves)
"aM" = (/obj/item/weapon/paper/photograph{icon_state = "photo_squad"; info = "Better times than these."},/turf/simulated/floor/plating/snow,/area/sheep/snow/graves)
"aN" = (/obj/item/toy/prize/ripley,/turf/simulated/floor/plating/snow,/area/sheep/snow/graves)
"aO" = (/obj/item/toy/plushie/mouse,/turf/simulated/floor/plating/snow,/area/sheep/snow/graves)
"aP" = (/turf/simulated/floor/holofloor{icon_state = "rampbottom"; dir = 2},/area/sheep/snow/graves)
"aQ" = (/obj/structure/bed/chair{dir = 1},/turf/simulated/floor/wood,/area/sheep/snow/graves)
"aR" = (/obj/structure/table/woodentable,/obj/item/device/flashlight/lantern,/obj/item/device/flashlight/lantern,/obj/item/device/flashlight/lantern,/turf/simulated/floor/wood,/area/sheep/snow/graves)
"aS" = (/obj/structure/table/woodentable,/turf/simulated/floor/wood,/area/sheep/snow/graves)
"aT" = (/obj/structure/bed,/obj/item/weapon/bedsheet,/turf/simulated/floor/wood,/area/sheep/snow/graves)
"aU" = (/obj/structure/table/woodentable,/obj/item/weapon/gun/projectile/shotgun/doublebarrel{ammo_type = /obj/item/ammo_casing/shotgun},/turf/simulated/floor/wood,/area/sheep/snow/graves)
"aV" = (/obj/structure/table/woodentable,/obj/item/clothing/suit/chaplain_hoodie,/obj/item/clothing/under/color/black,/obj/item/clothing/shoes/combat,/obj/item/clothing/mask/gas,/obj/item/clothing/head/det_hat,/obj/item/clothing/glasses/eyepatch,/obj/item/clothing/accessory/holobadge,/turf/simulated/floor/wood,/area/sheep/snow/graves)
"aW" = (/obj/structure/filingcabinet/filingcabinet,/turf/simulated/floor/wood,/area/sheep/snow/graves)
"aX" = (/obj/structure/coatrack,/turf/simulated/floor/wood,/area/sheep/snow/graves)
"aY" = (/obj/structure/closet,/turf/simulated/floor/wood,/area/sheep/snow/graves)

(1,1,1) = {"
aaaaaaaaaaaaaaaaaaaaaaaaaaaaaaaaaaaaaaaaaaaaaaaaaaaaaaaaaaaaaaaaaaaaaaaaaaaaaaaaaaaaaaaaaaaaaaaaaaaa
aaaaaaaaaaaaaaaaaaabababababababababababababababababababababaaaaaaaaaaaaaaaaaaaaaaaaaaaaaaaaaaaaaaaa
aaaaaaaaaaaaaaabababababababababababababababababababababababababababababababababaaaaaaaaaaaaaaaaaaaa
aaaaaaaaaaaaababababababababababababababababababababababababababababababababababababaaaaaaaaaaaaaaaa
aaaaaaaaaaaaababababababababababababababababababababababababababababababababababababababababaaaaaaaa
aaaaaaaaaaababababababababababababababababababababababababababababababababababababababababababababaa
aaaaaaaaaaababababababababababababababababababababababababababababababababababababababababababababaa
aaaaaaababababababababababababababababababababababababababababababababababababababababababababababaa
aaaaabababababababababababababababababababababababababababababababababababababababababababababababaa
aaababababababababababababababababababababababababababababababababababababababababababababababababaa
aaababababababababababababababababababababababababababababababababababababababababababababababababaa
aaababababababababababababababababababababababababababababababababababababababababababababababababaa
aaababababababababababababababababababababababababababababababababababababababababababababababababaa
aaababababababababababababababababababababababababababababababababababababababababababababababababaa
aaababababababababababababababababababababababababababababababababababababababababababababababababaa
aaababababababababababababababababababababababababababababababababababababababababababababababababaa
aaababababababababababababababababababababababababababababababababababababababababababababababababaa
aaababababababababababababababababababababababababababababababababababababababababababababababababaa
aaababababababababababababababababababababababababababababababababababababababababababababababababaa
aaababababababababababababababababababababababababababababababababababababababababababababababababaa
aaababababababababababababababababababababababababababababababababababababababababababababababababaa
aaababababababababababababababababababababababababababababababababababababababababababababababababaa
aaababababababababababababababababababababababababababababababababababababababababababababababababaa
aaababababababababababababababababababababababababababababababababababababababababababababababababaa
aaababababababababababababababababababababababababababababababababababababababababababababababababaa
aaababababababababababababababababababababababababababababababababababababababababababababababababaa
aaababababababababababababababababababababababababababababababababababababababababababababababababaa
aaababababababababababababababababababababababababababababababababababababababababababababababababaa
aaababababababababababababababababababababababababababababababababababababababababababababababababaa
aaababababababababababababacacacacacacacacacacacacacacacacacacadaeafagahaiajakalabababababababababaa
aaababababababababababababacamamamacananananaoapaqarananananacababasabatabauabavabababababababababaa
aaababababababababababababacawaxaxacananananananananananananacababababababababavabababababababababaa
aaababababababababababababacayaxaxacananananazananaAananananacabaBaCaDaEaFaBaGavabababababababababaa
aaababababababababababababacacaxaxacaHaHaIaJaKaLaLaLaIaJaHaHacabababaMabaNabaOavabababababababababaa
aaababababababababababababababababacaPaPaxaxaxaxaxaxaxaxaPaPacababababababababavabababababababababaa
aaababababababababababababababababacaxaxaxaxaxaxaxaxaxaxaxaxacabaBaBaBaBaBaBaBavabababababababababaa
aaababababababababababababababababacaxaxaQaQaQaxaxaQaQaQaxaxacababababababababavabababababababababaa
aaababababababababababababababababacaxaxaxaxaxaxaxaxaxaxaxaxacababababababababababababababababababaa
aaababababababababababababababababacaxaxaQaQaQaxaxaQaQaQaxaxacababababababababababababababababababaa
aaababababababababababababababababacaxaxaxaxaxaxaxaxaxaxaxaxacababababababababababababababababababaa
aaababababababababababababababababacaxaxaxaxaxaxaxaxaxaxaxaxacababababababababababababababababababaa
aaababababababababababababababababacacacacacacaxaxaRaRaSaSaSacababababababababababababababababababaa
aaababababababababababababababababacaTaUaVaWacaxaxaxaxaxaxaxacababababababababababababababababababaa
aaababababababababababababababababacaxaxaxaxaxaxaxaXaXaYaYaYacababababababababababababababababababaa
aaaaabababababababababababababababacacacacacacaxaxacacacacacacababababababababababababababababababaa
aaaaaaabababababababababababababababababababababababababababababababababababababababababababababaaaa
aaaaaaaaabababababababababababababababababababababababababababababababababababababababababababaaaaaa
aaaaaaaaaaaaaaabababababababababababababababababababababababababababababababababababababababaaaaaaaa
aaaaaaaaaaaaaaaaaaababababababababababababababababababababababababababababababababababababaaaaaaaaaa
aaaaaaaaaaaaaaaaaaaaaaaaaaaaaaaaaaaaaaaaaaaaaaaaaaaaaaaaaaaaaaaaaaaaaaaaaaaaaaaaaaaaaaaaaaaaaaaaaaaa
"}
